1111111111111
1P00000011111
1000000000011
1001000000001
1000000000001
10000000000C1
1100001001E11
1111111111111
