1111111111111111111111111
1000100C100C001C001C00001
1010101010101010101010101
1010101010101010101010101
1010101010101010101010101
1010101010101010100010101
1010101010101010101010101
1010100010101010101010101
1P0C0C0C000C000C00C000E11
1111111111111111111111111
1111111111111111111111111
