1111111111111
1P00000000001
1C11111111111
1000000010E01
111111C110011
10000C0000001
1111111111111
